(sic)	D
Bασιλείου	Basil
Αὐτοῦ	Same
Βασιλείου	Basil
Γεμμαδόπυ	Gennadius
Γενναδίου	Gennadius
Διδύμου	Didymus
Διοδώρου	Diodorus
Δρυσοστόμου	Chrysostom
Εὐθαλίου	Euthalius
Θεοδψρήτου	Theodoret
Θεοδωρήτου	Theodoret
Θεοδωρήυου	Theodoret
Θεοδωρώτου	Theodoret
Θεοδόγου	Theodore
Θεοδώρητου	Theodoret
Θεοδώρου	Theodore
Θεολωρήτου	Theodoret
Θεολόγου	Theodore
Θεοσωρήτου	Theodoret
Θεοφωρήτου	Theodoret
Θεοφώρου	Theodore
Θωτίου	Photius
Ισιδώρου	Isidore
ΚΥΡÍΛΛΩΥ	Cyril
Κλισλρίου	Caesarius
Κλήμεντοσ	Clement
Κυρίδδου	Cyril
Κυρίκκου	Cyril
Κυρίλλου	Cyril
Μαδίμου	Maximus
Μαξίμου	Maximus
Μεθοδίου	Methodius
Μεθοφίου	Methodius
Μονάκου	Monachus
Μονάκχου	Monachus
Μονάχου	Monachus
Νύσσησ	Nyssa
Οἰκουμενίου	Oecumenius
Οίκουμενίου	Oecumenius
Πατάρεωσ	Patara
Σευηριανοῦ	Severianus
Φεοδωρήτου	Theodoret
Φωτίου	Photius
Φωίου	Photius
Χργσοστόμου	Chrysostom
Χρτσοστόμου	Chrysostom
Χρυσολόγου	Chrysologus
Χρυσορειθρολόγου	Chysoreithrologus
Χρυσορήμονοσ	Chrysoremonos
Χρυσοστομου	Chrysostom
Χρυσοστόμου	Chrysostom
Χρυσοστόμου	Chrysostom
Χρυσοσόμου	Chrysostom
Xρυστόμου	Chrysostom
Χρυσοχριστοστόμου	Chrysostom
Ωριγένουε	Origen
Ωριγένουσ	Origen
Ωριγέσνουσ	Origen
μονάκου	Monachus
νύσσησ	Nyssa
Ἀκακίου	Agathius
Ἀποστόαου	Apostolos
Ἀποστόλου	Apostolos
Ἰσιδωρου	Isidore
Ἰσιδώρου	Isidore
Ἰσισώρου	Isidore
Ὡριγένουσ	Origen